...........
1..........
12.........
123........
1235.......
12354......
123541.....
1235412....
12354123...
123541235..
1235412354.
99999999991
...........
...........
...........
...........
...........
...........
...........
...........
