...........
...........
33333333333
...........
00099999999
...........
44444444444
...........
99999999000
...........
66666666666
...........
55599999999
...........
55555555555
...........
99999999555
...........
...........
...........
