...........
...........
...........
...........
....725....
...73527...
...25371...
..3527341..
..5371437..
..2734173..
..7143725..
..3417352..
..4372537..
...73527...
...25371...
....273....
...........
...........
...........
...........
