...........
...........
...........
...........
88888888888
44444444444
55555555555
77777777777
66666666666
33333333333
...........
...........
...........
...........
...........
...........
...........
...........
...........
...........
