.9.........
...........
.9.........
.9.........
.9....5....
.9...525...
.9..52525..
.9.5258525.
.9..52525..
.9...525...
.9....5....
.9.........
.9.........
.9.........
.9.........
.9999999999
...........
...........
...........
...........
