...........
...........
48888888884
9.........9
55555555555
...........
18888888881
9.........9
55555555555
...........
58888888885
9.........9
44444444444
...........
44444444444
9.........9
...........
...........
...........
...........
