...........
...........
...........
28822222882
28782228382
28778883382
28777833382
28777833382
28777833382
28777833382
28777833382
28777833382
22877833822
22287838222
22228882222
...........
...........
...........
...........
...........
