...........
...........
.....9.....
...00.00...
.00..9..00.
0..77.77..0
.77..9..77.
7..33.33..7
.33..9..33.
3..44.44..3
.44..9..44.
4..55.55..4
.55..9..55.
5..33.33..5
.33.....33.
3.........3
...........
...........
...........
...........
