...........
...........
.....8.....
...55833...
..5500033..
.550000033.
.550000033.
.550000033.
.8.8.8.8.8.
.....8.....
.....8.....
...9.9.....
...999.....
....9......
...........
...........
...........
...........
...........
...........
