...........
...........
..9999999..
..3459543..
..3459543..
..3459543..
..3459543..
..3459543..
..3459543..
..3459543..
..9999999..
...........
...........
...........
...........
...........
...........
...........
...........
...........
