...........
...........
...........
39192939691
69898989892
..6........
.9.969.9.9.
.9.9.969.9.
.9.9.9.969.
...........
.9.9.969.9.
.9.969.9.9.
..69.9.9...
6....9.....
...........
...........
...........
...........
...........
...........
