...........
...........
...........
.911111119.
.9.......9.
.9.99999.9.
.9.95559.9.
.9.96669.9.
.9.93339.9.
.9.91119.9.
.9.92229.9.
.9.......9.
.9.......9.
.999999999.
...........
...........
...........
...........
...........
...........
