...........
...........
...........
77777777777
77777777777
...........
49.94449.94
49.94449.94
49.94449.94
49.94449.94
...........
00000000000
00000000000
...........
...........
...........
...........
...........
...........
...........
