...........
...........
...........
...........
...........
....000....
....000....
....000....
...05050...
...55555...
..5555555..
..5555555..
.555555555.
55555555555
...........
...........
...........
...........
...........
...........
