...........
...........
...........
44444444444
33333333333
55555555555
99994449999
93398889339
9449...9559
9.........9
9.........9
9.........9
9..93339..9
98899999889
...........
...........
...........
...........
...........
...........
