...........
...........
...........
...........
..9889.....
.9....9....
9..22..9...
9.5555.9...
9..66..9...
.9....9....
..9999.....
...........
...........
...........
...........
...........
...........
...........
...........
...........
