...........
...........
...........
...........
...........
...........
...........
88888888888
77777777777
88888888888
...........
88888888888
44444444444
88888888888
...........
...........
...........
...........
...........
...........
