...........
...........
...........
55555555555
59996969995
59.......95
596.....695
5966...6695
.5966.6695.
..5966695..
...59695...
....565....
.....5.....
...........
...........
...........
...........
...........
...........
...........
