...........
...........
...........
...........
16.........
1623.......
162316.....
16231623...
8623162316.
.9831623162
...98623162
.....983162
.......9862
.........98
...........
...........
...........
...........
...........
...........
