...........
.....44....
....4884...
....4844...
....4444...
....4444...
....4444...
....4444...
...334445..
..38844885.
..38335855.
..33335555.
..33335555.
..33335555.
..33335555.
...33..55..
...........
...........
...........
...........
