...........
...........
...........
......222..
......226..
.....22666.
.....22265.
.....22225.
....922225.
....152255.
....11555..
...919555..
...1111....
..9191.....
..1111.....
..111......
.111.......
.11........
...........
...........
