.........0.
.........00
...0000....
....0000...
.....999...
..0........
.010.......
01910......
.010.......
..0.......1
..6..9.333.
3.6.3.3.363
9363.6393..
9363.3.133.
99393..33..
...........
...........
...........
...........
...........
