...........
...........
...7...7...
....7.7....
....7.7....
...88888...
...88888...
..8848488..
..8848488..
.888888888.
.888888888.
.8.88888.8.
.8.8...8.8.
.8.8...8.8.
....8.8....
....8.8....
...........
...........
...........
...........
