...........
...........
...........
.9..9.9..9.
.99.....99.
.....1.....
....939....
..9..7..9..
.....5.....
..9..4..9..
....939....
.....7.....
.99.....99.
.9..9.9..9.
...........
...........
...........
...........
...........
...........
