...........
...........
.9.9...9.9.
.939...939.
.959...959.
.999...999.
...........
...65557...
...63237...
...62327...
...63237...
...62327...
...65557...
...........
...........
...........
...........
...........
...........
...........
